1111111111111111111111111111111111
1E0000000000110C00000C000000000001
1110011100000000101111000000010101
1000010011100000001001000000011101
1P0000000C00C0000000000000000000C1
1111111111111111111111111111111111