1111111111111111111111111111111111111111
1111111111111111111111111111111111111111
111100000000C000KKKKKKKKKKC0000000001111
111100000000D0000000C00000000KKKK0001111
1111E00000D0000KK0C00000C000000000001111
1111KKK0KKK0000000000KKKK0000000K0K01111
1111000D000KKK00000000000000D000KKK01111
1111P0000000C000000000D000000000000C1111
1111000000D0000000KKK00000D0000000KK1111
111100000KKKKKKKKC000000D000000C00001111
1111111111111111111111111111111111111111
1111111111111111111111111111111111111111
1111111111111111111111111111111111111111