1111111111111111111111111111111111
1E1000000000110C00000C000000000001
1110011100000000101111000000010101
1000010011100000001001000D00011101
1P0000000C00C000000D000000000000C1
1111111111111111111111111111111111